11111111111111111111111111111111111111111111
10000P1000000001C00001C1100000000M0000011001
1100011C01000001100001001M0001C0100000C11001
10011111111000001000110011000111100001111101
100C10000010000010000000000001C1000000100101
1001110M001000000000001111110000001111100101
11001000011100001100001111111100001111100001
1000110001C10000100000111111C1010111C1100101
110001100101001000000111111100000M0000001001
10000100000000011110011111111C11111111000001
1000000000110000110000M000000000000011000001
10111011100000C00001111111111111100000000011
10000M000011111111000010001000000001101C1001
11100011101010000000001101100000001100111001
11100001001100000001100100100001100000000001
1C0000010000000000001C00000011000M0001111001
10000100010000001C001100000000000011C00000E1
1110C111111111011111111111111111111110000011
111111100000010M0000000000100C00000001000001
11111111001100000000011100000000000000011111
11111C00000100010001001000100000100000000111
11111111111111111111111111111111111111111111