111111111111111111
1P00000C0000100011
100000000000100001
1000000100C00010E1
1000C000100M011111
1001001000000100C1
100100100000000111
10011C0010010000M1
111111111111111111