11111111111
100P0000101
1E0000001C1
11111111111